quoi|feur
quoi ?|feur
quoi?|On met un espace avant le point d'interrogation sale illettré. 
hein|deux
ok|LM
pardon|my French
oui|stiti
c'est qui ?|c'est pas moi
j'ai peur|moi aussi
bonjour|Enchanté moi c'est Brenda
jsp|moi non plus
Nope|on dit "non" c'est plus poli
?|aucune idée
merci|de rien
bonne nuit|faites de beau rêves
rip|qui est décédé ?
d'accord|nice
nickel|c'est trop bien !!!
bizarre|Je dirais même : C'est très bizarre……… 
c'est bon|c'est-à-dire ?
ah|beh
yep|En français on dit "oui"
Tg|Pour ceux qui n'aurait pas compris, "Tg" est l'abréviation de "Ta gueule"
J'arrive|attendez-moi
Gg|!
Merci !|DE RIEN !
tkt|bah un peu quand même
Feur|sur ce groupe, le Feur relève de ma compétence
exactement|c'est-à-dire ?
PPP ?|j'approuve ce message
Nice !|Nice se situe au sud-est de la France, à proximité de l'Italie
mdr|Ahahahahahah !!!
Oh|Oui bon c'est bon, c'est pas si extraordinaire que ça